Icon_image_list.txt

Contains a list of which icons go with which abilities.

Spells:

  Tier I:
    Arcane Dart        :: water-bolt.svg
    Arcane Warding     :: juggler.svg
    Mystic Shield      :: energy-shield.svg
    Flicker of Life    :: candle-flame.svg
    Stone Guard        :: stone-sphere.svg
    Singe              :: fire-bowl.svg
    Chill              :: snowflake-2.svg
    Shock              :: lightning-frequency.svg
    Suggest:Laziness   :: oppression.svg
    Stutter            :: drama-masks.svg
    Cloud Vision       :: sunken-eye.svg
    Haunt              :: ghost.svg
    Zone of Silence    :: nothing-to-say.svg
    Blurry             :: two-shadows.svg
    Weapon Enhance     :: sparkling-saber.svg
    Flaming Weapon     :: flaming-trident.svg        
    
  Tier II:
    Arcane Burst       :: spiked-shell.svg
    Identification     :: uncertainty.svg
    Hovering Shield    :: winged-shield.svg
    Fright             :: terror.svg
    Infection          :: syringe.svg
    Hands of Healing   :: magic-palm.svg
    Elemental Boon     :: magic-shield.svg
    Torrent            :: wave-crest.svg
    Lightning Bolt     :: focused-lightning.svg
    Suggest: Cowardice :: back-pain.svg
    Pit                :: impact-point.svg
    Smoke Screen       :: heat-haze.svg
    Shrink             :: inner-self.svg
    Frost Weapon       :: frozen-arrow.svg

  Tier III:
    Runic Circle of Protection :: reticule.svg
    Runic Cirlce of Defiance   :: targeting.svg
    Arcane Missile Barrage     :: energy-arrow.svg    
    Expunge                    :: hospital-cross.svg
    Spiritual Beam             :: hypersonic-bolt.svg
    Charge                     :: energise.svg
    Torch                      :: burning-passion.svg
    Icy Mist                   :: snowing.svg
    Exude Darkness             :: death-zone.svg
    Fever                      :: psychic-waves.svg
    Dump Mana                  :: ink-swirl.svg
    Periphery                  :: distraction.svg
    Dazzling Lights            :: star-pupil.svg
    Spellhunger Weapon         :: winged-sword.svg

Traits:

  Fighter:
    Parry             :: sword-clash.svg
    Preparation       :: stopwatch.svg
    Tank              :: lamellar.svg
    Fencer            :: scale-mail.svg
    Shield Resilience :: arrows-shield.svg
    Bully             :: muscle-up.svg
    Boldness          :: strong.svg
    Well Travelled    :: walking-boot.svg
    Hammer and Anvil  :: anvil-impact.svg
    
  Thief:
    Uncanny Evasion     :: ninja-mask.svg
    Stealthy Daggers    :: rogue.svg
    Dueling             :: stiletto.svg
    Two-weapon Fighting :: spinning-blades.svg
    Clever              :: fox-head.svg
    Lucky               :: king.svg
    Discerning Eyes     :: gaze.svg
    Treasure Hunter     :: metal-disk.svg
    Dilatant            :: radial-balance.svg

  Ranger:
    Wounding Projectiles :: nailed-foot.svg
    Melee Archery        :: high-shot.svg
    Nature Training      :: laurels.svg
    Explorer             :: footprint.svg
    Trapsmith            :: tripwire.svg
    Dangerous Traps      :: hazard-sign.svg
    Mastermind           :: over-infinity.svg
    Followup Expert      :: striking-diamonds.svg
    Trap Sadism          :: tribal-mask.svg
    
  Wizard:
    Resevoir             :: spiral-bottle.svg
    Survivor             :: heart-bottle.svg
    Spell Focus(all)     :: gift-of-knowledge.svg

Skills:

  Fighter:
    Mighty Blow              :: battle-axe.svg
    Brace                    :: guarded-tower.svg
    Dash                     :: wingfoot.svg
    Quick Strike             :: knife-thrust.svg
    Precise Blow             :: target-shot.svg
    Thrust                   :: spiral-thrust.svg
    Clobber                  :: hammer-drop.svg
    Wound Leg                :: nailed-foot.svg
    Wound Arm                :: cut-palm.svg
    Combo Attack             :: sword-array.svg
    Rush                     :: sprint.svg
    
  Ranger:
    Longbow Proficiency      :: pocket-bow.svg
    Expert Notch             :: high-shot.svg
    Trap Shrapnel            :: cogsplosion.svg
    Tunnel Vision            :: spectacle-lenses.svg
    Trap Sticky              :: goo-explosion.svg
    Balm                     :: honeypot.svg
    Rapid Reload             :: scalpel-strike.svg
    Ranger's Aim             :: target-arrows.svg    
    Trap Boulder-Pit         :: rock.svg
    Defensive Slash          :: quick-slash.svg
    Double Shot              :: double-shot.svg    
    Trap Tar                 :: burst-blob.svg

  Wizard:
    Magic Guard              :: eye-shield.svg
    Gather                   :: magic-swirl.svg
    Apply Salve              :: brandy-bottle.svg
    Spell Sight              :: brass-eye.svg
    Runic Dust               :: smoking-finger.svg
    Befuddle                 :: jigsaw-box.svg



Last updated: Dec. 27th, 2012